14567890q1
A        2
A        3
A        4
A      AA1
1LMK     1
P        B
Q        C
J  A     D
1IH1GNOFE1